# Syntax Coloring Map For WiFiCreds

# Datatypes (KEYWORD1)
WiFiCreds	KEYWORD1

# Methods and Functions (KEYWORD2)
getSSID	KEYWORD2
getPassword	KEYWORD2
isValid	KEYWORD2
getSSIDLength	KEYWORD2
getPasswordLength	KEYWORD2
getCredentialCount	KEYWORD2
getCredentialName	KEYWORD2
hasCredential	KEYWORD2
getDefaultName	KEYWORD2

# Constants (LITERAL1)
CREDENTIAL_SETS	LITERAL1

# Arduino R4 specific (KEYWORD1)
ARDUINO_BOARD	KEYWORD1
F_CPU	KEYWORD1
FLASHEND	KEYWORD1
RAMEND	KEYWORD1

# Data Types (KEYWORD1)
CredentialSet	KEYWORD1 